22
27
%%%%%%%%%%%%%%%%%%%%%%%%%%%
%            %            %
% %%%% %%%%% % %%%%% %%%% %
% %%%% %%%%% % %%%%% %%%% %
%@                       @%
% %%%% % %%%%%%%%% % %%%% %
%      %     %     %      %
%%%%%% %%%%%#%#%%%%% %%%%%%
#####% %###########% %#####
#####% %#%%%###%%%#% %#####
#####% ##%*#*#*#*%## %#####
#####% %#%%%%%%%%%#% %#####
#####% %###########% %#####
%%%%%% %#%%%%%%%%%#% %%%%%%
%            %            %
% %%%% %%%%% % %%%%% %%%% %
%@   %       &       %   @%
%%%% % % %%%%%%%%% % % %%%%
%      %     %     %      %
% %%%%%%%%%% % %%%%%%%%%% %
%                         %
%%%%%%%%%%%%%%%%%%%%%%%%%%%
